"filename", "language", "CSS", "JavaScript", "HTML", "comment", "blank", "total"
"d:\OneDrive\Prog\Web\WebGL\Easy3D_WebGL\ver5.css", "CSS", 58, 0, 0, 9, 5, 72
"d:\OneDrive\Prog\Web\WebGL\Easy3D_WebGL\ver5.js", "JavaScript", 0, 387, 0, 25, 122, 534
"d:\OneDrive\Prog\Web\WebGL\Easy3D_WebGL\ver5\E3D_Engine.js", "JavaScript", 0, 73, 0, 5, 14, 92
"d:\OneDrive\Prog\Web\WebGL\Easy3D_WebGL\ver5\animation.js", "JavaScript", 0, 471, 0, 61, 183, 715
"d:\OneDrive\Prog\Web\WebGL\Easy3D_WebGL\ver5\camera.js", "JavaScript", 0, 240, 0, 24, 82, 346
"d:\OneDrive\Prog\Web\WebGL\Easy3D_WebGL\ver5\collision.js", "JavaScript", 0, 1584, 0, 276, 529, 2389
"d:\OneDrive\Prog\Web\WebGL\Easy3D_WebGL\ver5\core.js", "JavaScript", 0, 285, 0, 38, 78, 401
"d:\OneDrive\Prog\Web\WebGL\Easy3D_WebGL\ver5\debug.js", "JavaScript", 0, 133, 0, 30, 32, 195
"d:\OneDrive\Prog\Web\WebGL\Easy3D_WebGL\ver5\entity.js", "JavaScript", 0, 542, 0, 85, 201, 828
"d:\OneDrive\Prog\Web\WebGL\Easy3D_WebGL\ver5\input.js", "JavaScript", 0, 824, 0, 98, 226, 1148
"d:\OneDrive\Prog\Web\WebGL\Easy3D_WebGL\ver5\math.js", "JavaScript", 0, 1727, 0, 120, 307, 2154
"d:\OneDrive\Prog\Web\WebGL\Easy3D_WebGL\ver5\mesh.js", "JavaScript", 0, 641, 0, 71, 217, 929
"d:\OneDrive\Prog\Web\WebGL\Easy3D_WebGL\ver5\resource.js", "JavaScript", 0, 156, 0, 4, 29, 189
"d:\OneDrive\Prog\Web\WebGL\Easy3D_WebGL\ver5\scene.js", "JavaScript", 0, 271, 0, 30, 104, 405
"d:\OneDrive\Prog\Web\WebGL\Easy3D_WebGL\ver5\shader.js", "JavaScript", 0, 437, 0, 21, 50, 508
"d:\OneDrive\Prog\Web\WebGL\Easy3D_WebGL\ver5\timing.js", "JavaScript", 0, 59, 0, 3, 24, 86
"d:\OneDrive\Prog\Web\WebGL\Easy3D_WebGL\ver5\utility.js", "JavaScript", 0, 50, 0, 6, 12, 68
"d:\OneDrive\Prog\Web\WebGL\Easy3D_WebGL\ver5demo.js", "JavaScript", 0, 15, 0, 10, 12, 37
"d:\OneDrive\Prog\Web\WebGL\Easy3D_WebGL\ver5demo1.html", "HTML", 0, 0, 10, 2, 0, 12
"d:\OneDrive\Prog\Web\WebGL\Easy3D_WebGL\ver5demo2.html", "HTML", 0, 0, 20, 3, 1, 24
"d:\OneDrive\Prog\Web\WebGL\Easy3D_WebGL\ver5demo3.html", "HTML", 0, 0, 27, 4, 4, 35
"d:\OneDrive\Prog\Web\WebGL\Easy3D_WebGL\ver5demo4.html", "HTML", 0, 0, 28, 4, 6, 38
"d:\OneDrive\Prog\Web\WebGL\Easy3D_WebGL\ver5demo5.html", "HTML", 0, 0, 27, 4, 6, 37
"d:\OneDrive\Prog\Web\WebGL\Easy3D_WebGL\ver5demo6.html", "HTML", 0, 0, 52, 4, 4, 60
"d:\OneDrive\Prog\Web\WebGL\Easy3D_WebGL\ver5demoAnim.js", "JavaScript", 0, 61, 0, 27, 40, 128
"d:\OneDrive\Prog\Web\WebGL\Easy3D_WebGL\ver5demoFail.js", "JavaScript", 0, 10, 0, 4, 3, 17
"d:\OneDrive\Prog\Web\WebGL\Easy3D_WebGL\ver5demoPrimitives.js", "JavaScript", 0, 112, 0, 17, 63, 192
"d:\OneDrive\Prog\Web\WebGL\Easy3D_WebGL\ver5demoShader.js", "JavaScript", 0, 60, 0, 23, 38, 121
"Total", "-", 58, 8138, 164, 1008, 2392, 11760